6 10
|--------|
|F..|..-.|
|..-|.@..|
|F.....-.|
|F.....-.|
|--------|